NO ./textures/fire.xpm
SO ./textures/mur64.xpm
WE ./textures/wall_wood.xpm
EA ./textures/txt1.xpm
F 255,0,0
C 0,255,0

11111111111111111111
10000000001000000001
10000000001000000001
10000000001000000001
10000000001000000001
10000000001000000001
10000000001000000001
10000000001000000001
1000000000N000000001
10000000000000000001
10000000000000000001
10000000000000000001
11111111111111111111