NO ./images/center.xpm
SO ./images/center.xpm
WE ./images/center.xpm
EA ./images/center.xpm
F 220,100,0
C 225,255,0

    11111111111111111111
    10000100000010000001
    10000100011110000001
    10000100000000000001
    10000000000000000001
    10000000000000100001
    10000000000000100001
    10000000000000101111
1111N000000011100001
10000000000000000001
10000000000000000001
10000000000000000001
11111111111111111111
