NO ./textures/fire.xpm
SO ./textures/mur64.xpm
WE ./textures/wall_wood.xpm
EA ./textures/txt1.xpm

F 0,0,255
C 0,255,0

11111111111111111111
10001000001000000001
10101011001000000001
10101011001000000001
10101011001000000001
10101011001000000001
10101011001000000001
10100011000000000001
10111111111101111111
10100000010000000001
1010000010000N000001
10100000000000000001
01111111111111111110
