11111111111111111111
10000100000010000001
10000100011110000001
10000100000000000001
11111110000000000001
10000000000000100001
10000000000000100001
10000000000000100001
1000P000000011100001
10000000000000000001
10000000000000000001
10000000000000000001
11111111111111111111