NO ./textures/txt1.xpm
SO ./textures/txt1.xpm
WE ./textures/txt1.xpm
EA ./textures/txt1.xpm
F 220,100,0
C 225,255,0

   11111111111111111111
  10010000000010100001
   10010000001000100001
  10000100001000001001
 10000001001000000011
10000000011000000001
10000000000000000001
 10000000000000000001
  10000000000000000001
   1000000000N000000001
  10000000000000000001
 10000000000000000001
11111111111111111111