NO ./textures/fire2.xp
SO ./textures/mur64.xpm
WE ./textures/wall_wood.xpm
EA ./textures/txt1.xpm
F 255,0,0
C 0,255,0

 111111111111111111
10001000001000000001
10101011001000000001
10101011001000000001
10101011001000000001
10101011001000000001
10101011001000000001
10100011000000000001
10111111111101111111
10100000000000000001
10100000000000000001
1E100000000000000001
 111111111111111111