111111111111
100001101011
100010010001
100100000001
1000000000N1
111111111111
