WE ./textures/fire.xpm
NO ./textures/mur64.xpm
SO ./textures/wall_wood.xpm
EA ./textures/txt1.xpm

F 0,0,100
C 0,100,0

11111111111111111111
10001000001000000001
10101011001000000001
10101011001000000001
10101011001000000001
10101011001000000001
10101011001000000001
10100011000000000001
10111111111101111111
10100000010000000001
101000010E0010000001
10100000000000000001
01111111111111111110