111111111111
100001101011
1000100100P1
100000000001
100000000001
100000000001
100000000001
100000000001
111111111111