NO ./textures/txt1.xpm
SO ./textures/txt1.xpm
WE ./textures/txt1.xpm
EA ./textures/txt1.xpm
F 220,100,0
C 225,255,0

11111111111111111111
10000000000000000001
10000000000000000001
10000100000000000001
10000000000000000001
10000000000000000001
10000000000000000001
10000000000000000001
10000000000000000001
10000000000000000001
10000000000N00000001
10000000000000000001
11111111111111111111