WE ./textures/fire.xpm
EA     ./textures/txt1.xpm
NO   ./textures/mur64.xpm
SO       ./textures/wall_wood.xpm
F            0,0,100
C  100,100,0

11111111111111111111
10001000001000000001                
10101011001000000001         
10101011001000100001
10101011001000000001
10101011001000100001
10100011000000000001
10111111111111111111
10000W00000000000001
11111111111111111111