NO ./textures/fire.xpm
SO ./textures/mur64.xpm
WE ./textures/wall_wood.xpm
EA ./textures/txt1.xpm
F 255,0,0
C 0,255,0

1111111111111111111111111111111111111111111111111111111111111111
1000100000100000000000000000000000000000000000000000000000E00001
1010101100100000000000000000000000000000000000000000000000000001
1010101100100000000000000000000000000000000000000000000000000001
1010101100100000000000000000000000000000000000000000000000000001
1010101100100000000000000000000000000000000000000000000000000001
1010101100100000000000000000000000000000000000000000000000000001
1010001100000000000000000000000000000000000000000000000000000001
1011111111110110000000000000000000000000000000000000000000101111
1010000000000000000000000000000000000000000000000000000000000001
1010000000000000000000000000000000000000000000000000000000000001
1010000000000000000000000000000000000000000000000000000000000001
1010000000000000000000000000000000000000000000000000000000000001
1010000000000000000000000000000000000000000000000000000000000001
1010000000000000000000000000000000000000000000000000000000000001
1010000000000000000000000000000000000000000000000000000000000001
1010000000000000000000000000000000000000000000000000000000000001
1010000000000000000000000000000000000000000000000000000000000001
1010000000000000000000000000000000000000000000000000000000000001
1010000000000000000000000000000000000000000000000000000000000001
1010000000000000000000000000000000000000000000000000000000000001
1010000000000000000000000000000000000000000000000000000000000001
1010000000000000000000000000000000000000000000000000000000000001
1010000000000000000000000000000000000000000000000000000000000001
1010000000000000000000000000000000000000000000000000000000000001
1010000000000000000000000000000000000000000000000000000000000001
1010000000000000000000000000000000000000000000000000000000000001
1010000000000000000000000000000000000000000000000000000000000001
1010000000000000000000000000000000000000000000000000000000000001
1010000000000000000000000000000000000000000000000000000000000001
1010000000000000000000000000000000000000000000000000000000000001
1010000000000000000000000000000000000000000000000000000000000001
1010000000000000000000000000000000000000000000000000000000000001
1010000000000000000000000000000000000000000000000000000000000001
1010000000000000000000000000000000000000000000000000000000000001
1010000000000000000000000000000000000000000000000000000000000001
1010000000000000000000000000000000000000000000000000000000000001
1010000000000000000000000000000000000000000000000000000000000001
1010000000000000000000000000000000000000000000000000000000000001
1010000000000000000000000000000000000000000000000000000000000001
1010000000000000000000000000000000000000000000000000000000000001
1010000000000000000000000000000000000000000000000000000000000001
1010000000000000000000000000000000000000000000000000000000000001
1111111111111111111111111111111111111111111111111111111111111111