NO ./textures/fire.xpm
SO ./textures/mur64.xpm
WE ./textures/wall_wood.xpm
EA ./textures/txt1.xpm
F 255,0,0
C 0,255,0

111111111111111111111111111111
 1000000000000000000000000001 
  10000000000000000000000001  
   100000000000000000000001   
    1000000000000000000001    
     10000000000000000001     
      100000000000000001      
       1000000000000001        
        10000000000001        
         100000000001
          1000000001
           10000001 
            100001
             10E1
              11